################
#X#    @       #
# #     L      #
# #          # #
# #          # #
# #          # #
# #          # #
# #          # #
# #          # #
# #          # #
# #          # #
# #          # #
# #          # #
# ############ #
#              #
################
